NO ./textures/north.xpm
SO ./textures/south.xpm
WE ./textures/west.xpm
EA ./textures/east.xpm
F 220,100,12
C 225,30,87

111111111111
100000000001
100011011001
100010001001
100010001001
100010001001
100000N00001
100010001001
100010001001
100011011001
100000000001
111111111111
111111111111