NO ./textures/Brick.xpm
SO ./textures/Metal.xpm
WE ./textures/Tile.xpm
EA ./textures/Wood.xpm

F 220,100,255                                  
C 225,30,0

11111111111
10000000001
10000N00001
10000000001
11111111111

1111
1001
1111