NO ./textures/deydoux.xpm
SO ./textures/mathybis.xpm
WE ./textures/max.xpm
EA ./textures/brieux.xpm

F 173,173,173
C 51,227,255

111111111111
100000000001      11111
1000000000011111111000111111    111111111111111
10000N0000000000000000000001    100000000000001
1000000000011111111000111101    100000000000001
100000000001      11011  101    100000000000001      111          111111111111111111111111
111111111111       101   10111111000000000000011111  101          100000000000000000000001
                   101   10000000000000000000000001  101          101100000000000000000001
        1111111111110111 10111111000000000000011101  101          101000000000000000000001
        1000000000000001 101    100000000000001 101  101    111111100000000000000000000001
        10010010010010011101    100000000000001 101  101    100000000000000000000000000001
        10000000000000000001    100000000000001 101  101    101000100000000000000000000001
        10010010010010011111    111111111111111 101111011111101111100000000000000000000001
        1000000000000001                        100000000000000000000000000000000000000001
        1111111001111111                        111011111110111111100000000000000000000001
              1001                                101     101     100000000000000000000001
              1001                                101     101     100000000000000000000001
            11100111                              111     101     100000000000000000000001
        1111100000011111111                               101     100000000000000000000101
        10000000000000000011111111111111111111111111111111101     100000000000000000001101
        10000000000000000000000000000000000000000000000000001     100000000000000000000001
        10000000000000000011111111111111111111111111111111111     111111111111111111111111
        1111100000011111111
            11111111